A
abiu - abiu
acai - acai berry
acerola - Barbados cherry
agrest - gooseberry
aka - ackee
akka sellowa - feijoa
ananas - pineapple
arbuz - watermelon
aronia - chokeberry
asymina - pawpaw
atemoya - atemoya
awokado - avocado

B
babako - babaco
banan - banana
bilimbi - bilimbi
borowka bagienna - bog blueberry
borowka brusznica - lingonberry
borowka czarna - billberry
borowka wysoka - high blueberry
brzoskwinia - peach

C
chempedak - cempedak
chlebowiec - breadfruit
cytron - citron
cytryna - lemon
czeresnia - wild cherry
czerymoja - cherimoya

D
daktyl - date
daktyl indyjski - tamarind fruit
durian - durian
dzakfrut - jackfruit

F
figa - fig

G
gozdzikowiec (eugenia stipitata) - araza fruit
gozdzikowiec jednokwiatowy - pitanga
granadilla - sweet granadilla
granat - pomegranate
grejpfrut - grapefruit
gruszka - pear
guanabana - soursop
gujawa - guava

J
jablko - apple
jablko cukrowe - sugar-apple
jablko jamajskie - custard apple
jagoda kamczacka - honeyberry
jezyna - blackberry
jujuba - jujube

K
karambola - starfruit
kasztan jadalny - sweet chestnut
kasztan wodny - water caltrop
kazimira jadalna - white sapote, Mexican apple
kiwano - horned melon, kiwano
kiwi - kiwi fruit
kumkwat - kumquat
kuruba - banana passionfruit

L
liczi - lychee
lima - key lime
longan - longan

M
malina - raspberry
mamea - mammee apple
mandarynka - mandarine, tangerine
mango - mango
mangostan - mangosteen
marakuja - passionfruit
melon - melon
migdal - almond
mirabelka - mirabelle plum
mircjaria - jabuticaba
morela - apricot
morwa - mulberry

N
nerkowiec - cashew
nashi - asian pear
nektarynka - nectarine
niesplik - loquat

O
oliwka - olive
opuncja - opuntia, prickly pear
orzech arachidowy - peanut
orzech brazylijski - Brazil nut
orzech kokosowy - coconut
orzech kola - kola nut
orzech laskowy - hazelnut
orzech macadamia - macadamia nut
orzech pekan - pecan
orzeszki pistacjowe - pistachio nuts
orzech wloski - walnut

P
pandan - pandan
papaja - papaya
persymona - persimmon
pigwa - quince
pitaja (smoczy owoc) - dragon fruit
pomarancza - orange
pomelo - pomelo
porzeczka czarna - blackcurrant
porzeczka czerwona - redcurrant
poziomka - wild strawberry
pulasan - pulasan

R
rambutan - rambutan
renkloda - greengage
roza dzika - dog rose
roza pomarszczona - rugosa rose, beach rose

S
saguaro - saguaro
salak - salak
sapodilla - sapodilla
slonecznik - sunflower
sliwiec slodki - ambarella
sliwa - plum
swidosliwa - shadbush

T
tamarillo - tamarillo
tarnina - blackthorn
truskawka - strawberry

U
umkokolo - umkokola

W
winogrono - grape
wisnia - cherry

Z
zurawina - cranberry